carretera	Nomen	v. 3 Stunden	
restaurante	Nomen	v. 3 Stunden	
comunidad	Nomen	v. 3 Stunden	
disponibles	Adjektiv	v. 3 Stunden	
igual	Adjektiv	v. 3 Stunden	
enfermo	Adjektiv	v. 3 Stunden	
independiente	Adjektiv	v. 3 Stunden	
oscuros	Adjektiv	v. 3 Stunden	
amplio	Adjektiv	v. 3 Stunden	
enferma	Adjektiv	v. 3 Stunden	
este	Pronomen	v. 3 Stunden	
otro	Pronomen	v. 3 Stunden	
varias	Bestimmungswort	v. 3 Stunden	
naturaleza	Nomen	v. 2 Stunden	
luna	Nomen	v. 2 Stunden	
cielo	Nomen	v. 2 Stunden	
salsa	Nomen	v. 43 Minuten	
azul	Adjektiv	v. 40 Minuten	
baño	Nomen	v. 40 Minuten	
naranja	Adjektiv	v. 40 Minuten	
sillas	Nomen	v. 40 Minuten	
cartera	Nomen	v. 40 Minuten	
piso	Nomen	v. 40 Minuten	
silla	Nomen	v. 40 Minuten	
amarillas	Adjektiv	v. 40 Minuten	
habitación	Nomen	v. 40 Minuten	
policía	Nomen	v. 35 Minuten	
mesera	Nomen	v. 35 Minuten	
especialidad	Nomen	v. 35 Minuten	
guardia	Nomen	v. 35 Minuten	
ingeniera	Nomen	v. 35 Minuten	
príncipe	Nomen	v. 35 Minuten	
enfermero	Nomen	v. 35 Minuten	
profesor	Nomen	v. 35 Minuten	
minuto	Nomen	v. 17 Stunden	
fiestas	Nomen	v. 17 Stunden	
madrugada	Nomen	v. 17 Stunden	
fiesta	Nomen	v. 17 Stunden	
fecha	Nomen	v. 17 Stunden	
minutos	Nomen	v. 17 Stunden	
naturales	Adjektiv	v. 16 Stunden	
tantos	Bestimmungswort	v. 16 Stunden	
tantas	Bestimmungswort	v. 16 Stunden	
local	Adjektiv	v. 16 Stunden	
profesionales	Adjektiv	v. 16 Stunden	
tradicionales	Adjektiv	v. 16 Stunden	
mismas	Adjektiv	v. 16 Stunden	
pescados	Nomen	v. 16 Stunden	
argentino	Adjektiv	gestern	
internacional	Adjektiv	gestern	
mexicano	Adjektiv	gestern	
norteamericana	Adjektiv	gestern	
legal	Adjektiv	gestern	
lógico	Adjektiv	gestern	
numerosas	Adjektiv	gestern	
similares	Adjektiv	gestern	
infantil	Adjektiv	gestern	
consciente	Adjektiv	gestern	
elevado	Adjektiv	gestern	
abierto	Adjektiv	gestern	
derecha	Nomen	gestern	
dirección	Nomen	gestern	
toco	Verb	gestern	
toca	Verb	gestern	
hacen	Verb	gestern	
vemos	Verb	gestern	
español	Nomen	gestern	
pájaros	Nomen	gestern	
madre	Nomen	gestern	
abuela	Nomen	gestern	
mamá	Nomen	gestern	
abuelo	Nomen	gestern	
primo	Nomen	gestern	
hermano	Nomen	gestern	
hermana	Nomen	gestern	
hermanos	Nomen	gestern	
vuelvo	Verb	gestern	
tomo	Verb	gestern	
importa	Verb	gestern	
importo	Verb	gestern	
mesa	Nomen	v. 2 Tagen	
jabón	Nomen	v. 2 Tagen	
sábana	Nomen	v. 2 Tagen	
limpia	Verb	v. 2 Tagen	
televisión	Nomen	v. 2 Tagen	
costa	Nomen	v. 2 Tagen	
cárcel	Nomen	v. 2 Tagen	
palacio	Nomen	v. 2 Tagen	
banco	Nomen	v. 2 Tagen	
salón	Nomen	v. 2 Tagen	
sala	Nomen	v. 2 Tagen	
universidad	Nomen	v. 2 Tagen	
ciudadano	Nomen	v. 2 Tagen	
trabajador	Nomen	v. 2 Tagen	
testigo	Nomen	v. 2 Tagen	
revolución	Nomen	v. 2 Tagen	
ciudadanos	Nomen	v. 2 Tagen	
amigos	Nomen	v. 2 Tagen	
ciudadana	Nomen	v. 2 Tagen	
costumbre	Nomen	v. 2 Tagen	
bilingüe	Adjektiv	v. 2 Tagen	
bonito	Adjektiv	v. 2 Tagen	
mayor	Adjektiv	v. 2 Tagen	
útiles	Adjektiv	v. 2 Tagen	
simple	Adjektiv	v. 2 Tagen	
demasiado	Adverb	v. 2 Tagen	
auto	Nomen	v. 2 Tagen	
bola	Nomen	v. 2 Tagen	
piezas	Nomen	v. 2 Tagen	
tren	Nomen	v. 2 Tagen	
pieza	Nomen	v. 2 Tagen	
médico	Nomen	v. 2 Tagen	
piernas	Nomen	v. 2 Tagen	
piel	Nomen	v. 2 Tagen	
cuello	Nomen	v. 2 Tagen	
patria	Nomen	v. 3 Tagen	
zonas	Nomen	v. 3 Tagen	
festival	Nomen	v. 3 Tagen	
hacienda	Nomen	v. 3 Tagen	
evolución	Nomen	v. 3 Tagen	
paisaje	Nomen	v. 3 Tagen	
lluvia	Nomen	v. 3 Tagen	
sol	Nomen	v. 3 Tagen	
hoja	Nomen	v. 3 Tagen	
viento	Nomen	v. 3 Tagen	
universo	Nomen	v. 3 Tagen	
torneo	Nomen	v. 3 Tagen	
fútbol	Nomen	v. 3 Tagen	
equipos	Nomen	v. 3 Tagen	
liga	Nomen	v. 3 Tagen	
equipo	Nomen	v. 3 Tagen	
contrato	Nomen	v. 3 Tagen	
junta	Nomen	v. 3 Tagen	
empresa	Nomen	v. 3 Tagen	
venta	Nomen	v. 3 Tagen	
cuenta	Nomen	v. 3 Tagen	
profesión	Nomen	v. 3 Tagen	
doctor	Nomen	v. 3 Tagen	
juez	Nomen	v. 3 Tagen	
rey	Nomen	v. 3 Tagen	
propia	Adjektiv	v. 3 Tagen	
corto	Adjektiv	v. 3 Tagen	
sola	Adjektiv	v. 3 Tagen	
incluye	Verb	v. 3 Tagen	
abro	Verb	v. 3 Tagen	
sueña	Verb	v. 3 Tagen	
esa	Bestimmungswort	v. 3 Tagen	
cada	Bestimmungswort	v. 3 Tagen	
ambas	Bestimmungswort	v. 3 Tagen	
tarde	Adverb	v. 3 Tagen	
azúcar	Nomen	v. 3 Tagen	
bandera	Nomen	v. 3 Tagen	
nota	Nomen	v. 3 Tagen	
máquina	Nomen	v. 3 Tagen	
pantalla	Nomen	v. 3 Tagen	
moto	Nomen	v. 3 Tagen	
página	Nomen	v. 3 Tagen	
moneda	Nomen	v. 3 Tagen	
páginas	Nomen	v. 3 Tagen	
pluma	Nomen	v. 3 Tagen	
foto	Nomen	v. 3 Tagen	
bomba	Nomen	v. 3 Tagen	
bolsa	Nomen	v. 3 Tagen	
bolsas	Nomen	v. 3 Tagen	
dinero	Nomen	v. 3 Tagen	
tarjeta	Nomen	v. 3 Tagen	
caja	Nomen	v. 3 Tagen	
radio	Nomen	v. 3 Tagen	
cosas	Nomen	v. 3 Tagen	
metro	Nomen	v. 3 Tagen	
kilómetro	Nomen	v. 3 Tagen	
noche	Nomen	v. 3 Tagen	
mayo	Nomen	v. 3 Tagen	
momento	Nomen	v. 3 Tagen	
anoche	Adverb	v. 3 Tagen	
escritorio	Nomen	v. 4 Tagen	
platos	Nomen	v. 4 Tagen	
ventana	Nomen	v. 4 Tagen	
plato	Nomen	v. 4 Tagen	
espejo	Nomen	v. 4 Tagen	
esponja	Nomen	v. 4 Tagen	
buen	Adjektiv	v. 4 Tagen	
real	Adjektiv	v. 4 Tagen	
justo	Adjektiv	v. 4 Tagen	
inteligente	Adjektiv	v. 4 Tagen	
dura	Adjektiv	v. 4 Tagen	
nuevo	Adjektiv	v. 4 Tagen	
buena	Adjektiv	v. 4 Tagen	
positiva	Adjektiv	v. 4 Tagen	
cara	Adjektiv	v. 4 Tagen	
buenos	Adjektiv	v. 4 Tagen	
pasada	Adjektiv	v. 4 Tagen	
muestra	Verb	v. 4 Tagen	
conoce	Verb	v. 4 Tagen	
comienza	Verb	v. 4 Tagen	
sigue	Verb	v. 4 Tagen	
otra	Bestimmungswort	v. 4 Tagen	
todos	Bestimmungswort	v. 4 Tagen	
toro	Nomen	v. 4 Tagen	
blanca	Adjektiv	v. 4 Tagen	
colores	Nomen	v. 4 Tagen	
estación	Nomen	v. 4 Tagen	
blanco	Adjektiv	v. 4 Tagen	
verde	Adjektiv	v. 4 Tagen	
calendario	Nomen	v. 4 Tagen	
aceite	Nomen	v. 4 Tagen	
cadena	Nomen	v. 4 Tagen	
papel	Nomen	v. 4 Tagen	
mochila	Nomen	v. 4 Tagen	
polvo	Nomen	v. 4 Tagen	
año	Nomen	v. 6 Tagen	
junio	Nomen	v. 6 Tagen	
empresario	Nomen	v. 6 Tagen	
capitán	Nomen	v. 6 Tagen	
periodista	Nomen	v. 6 Tagen	
cocinero	Nomen	v. 6 Tagen	
mejores	Adjektiv	v. 6 Tagen	
tradicional	Adjektiv	v. 6 Tagen	
entro	Verb	v. 6 Tagen	
zapato	Nomen	v. 1 Woche	
abrigos	Nomen	v. 1 Woche	
botas	Nomen	v. 1 Woche	
esposa	Nomen	v. 1 Woche	
abril	Nomen	v. 1 Woche	
cita	Nomen	v. 1 Woche	
dormitorio	Nomen	v. 1 Woche	
sartén	Nomen	v. 1 Woche	
sacerdote	Nomen	v. 1 Woche	
jefe	Nomen	v. 1 Woche	
pequeña	Adjektiv	v. 1 Woche	
propios	Adjektiv	v. 1 Woche	
reciente	Adjektiv	v. 1 Woche	
familiar	Adjektiv	v. 1 Woche	
próximo	Adjektiv	v. 1 Woche	
importante	Adjektiv	v. 1 Woche	
finales	Adjektiv	v. 1 Woche	
quieres	Verb	v. 1 Woche	
nada	Verb	v. 1 Woche	
camina	Verb	v. 1 Woche	
hora	Nomen	v. 1 Woche	
enero	Nomen	v. 1 Woche	
semanas	Nomen	v. 1 Woche	
primavera	Nomen	v. 1 Woche	
vaso	Nomen	v. 1 Woche	
cuántos	Bestimmungswort	v. 1 Woche	
mediodía	Nomen	v. 1 Woche	
negro	Adjektiv	v. 1 Woche	
marzo	Nomen	v. 1 Woche	
alto	Adjektiv	v. 1 Woche	
largo	Adjektiv	v. 1 Woche	
barato	Adjektiv	v. 1 Woche	
capaz	Adjektiv	v. 1 Woche	
feo	Adjektiv	v. 1 Woche	
principales	Adjektiv	v. 1 Woche	
depende	Verb	v. 1 Woche	
siente	Verb	v. 1 Woche	
encuentra	Verb	v. 1 Woche	
busca	Verb	v. 1 Woche	
prueba	Verb	v. 1 Woche	
empieza	Verb	v. 1 Woche	
batería	Nomen	v. 1 Woche	
motor	Nomen	v. 1 Woche	
botella	Nomen	v. 1 Woche	
columna	Nomen	v. 1 Woche	
bicicleta	Nomen	v. 1 Woche	
padre	Nomen	v. 1 Woche	
solo	Adjektiv	v. 1 Woche	
son	Verb	v. 35 Minuten	
él	Pronomen	v. 35 Minuten	
con	Präposition	v. 35 Minuten	
el	Bestimmungswort	v. 35 Minuten	
es	Verb	v. 35 Minuten	
soy	Verb	v. 35 Minuten	
noviembre	Nomen	v. 1 Woche	
agosto	Nomen	v. 1 Woche	
hasta	Präposition	v. 1 Woche	
estudiante	Nomen	v. 1 Woche	
poeta	Nomen	v. 1 Woche	
artista	Nomen	v. 1 Woche	
ingeniero	Nomen	v. 1 Woche	
mejor	Adjektiv	v. 1 Woche	
necesarios	Adjektiv	v. 1 Woche	
natural	Adjektiv	v. 1 Woche	
responsable	Adjektiv	v. 1 Woche	
personales	Adjektiv	v. 1 Woche	
estáis	Verb	v. 1 Woche	
están	Verb	v. 1 Woche	
todo	Bestimmungswort	v. 1 Woche	
escalera	Nomen	v. 1 Woche	
cuántos	Pronomen	v. 1 Woche	
mes	Nomen	v. 1 Woche	
las	Bestimmungswort	v. 40 Minuten	
la	Bestimmungswort	v. 43 Minuten	
suéter	Nomen	v. 1 Woche	
ropa	Nomen	v. 1 Woche	
ve	Verb	v. 1 Woche	
corro	Verb	v. 1 Woche	
cocino	Verb	v. 1 Woche	
pintor	Nomen	v. 1 Woche	
mismo	Adjektiv	v. 1 Woche	
pasta	Nomen	v. 1 Woche	
jóvenes	Adjektiv	v. 1 Woche	
llega	Verb	v. 1 Woche	
pesa	Verb	v. 1 Woche	
acaba	Verb	v. 1 Woche	
vegetariano	Adjektiv	v. 1 Woche	
octubre	Nomen	v. 1 Woche	
cocina	Nomen	v. 1 Woche	
techo	Nomen	v. 1 Woche	
grande	Adjektiv	v. 1 Woche	
enorme	Adjektiv	v. 1 Woche	
pequeño	Adjektiv	v. 1 Woche	
o	Konjunktion	v. 1 Woche	
importantes	Adjektiv	v. 1 Woche	
viejo	Adjektiv	v. 1 Woche	
recientes	Adjektiv	v. 1 Woche	
años	Nomen	v. 1 Woche	
juntos	Adjektiv	v. 2 Wochen	
pobre	Adjektiv	v. 2 Wochen	
lámpara	Nomen	v. 2 Wochen	
actores	Nomen	v. 2 Wochen	
sacerdotes	Nomen	v. 2 Wochen	
actor	Nomen	v. 2 Wochen	
mesero	Nomen	v. 2 Wochen	
soldado	Nomen	v. 2 Wochen	
única	Adjektiv	v. 2 Wochen	
todas	Bestimmungswort	v. 2 Wochen	
respeta	Verb	v. 2 Wochen	
amarillo	Adjektiv	v. 2 Wochen	
veo	Verb	v. 2 Wochen	
va	Verb	v. 2 Wochen	
hijos	Nomen	v. 2 Wochen	
traje	Nomen	v. 2 Wochen	
vestido	Nomen	v. 2 Wochen	
corbata	Nomen	v. 2 Wochen	
abrigo	Nomen	v. 2 Wochen	
altas	Adjektiv	v. 2 Wochen	
gatos	Nomen	v. 2 Wochen	
secadora	Nomen	v. 2 Wochen	
secretaria	Nomen	v. 2 Wochen	
autor	Nomen	v. 2 Wochen	
conductor	Nomen	v. 2 Wochen	
miércoles	Nomen	v. 2 Wochen	
mañana	Nomen	v. 2 Wochen	
pública	Adjektiv	v. 2 Wochen	
populares	Adjektiv	v. 2 Wochen	
conocen	Verb	v. 2 Wochen	
acepta	Verb	v. 2 Wochen	
muestras	Verb	v. 2 Wochen	
finalmente	Adverb	v. 2 Wochen	
bien	Adverb	v. 2 Wochen	
duermen	Verb	v. 2 Wochen	
cuchara	Nomen	v. 2 Wochen	
abogado	Nomen	v. 2 Wochen	
vuelve	Verb	v. 2 Wochen	
positivo	Adjektiv	v. 2 Wochen	
diferentes	Adjektiv	v. 2 Wochen	
rápidamente	Adverb	v. 2 Wochen	
vehículo	Nomen	v. 2 Wochen	
campana	Nomen	v. 2 Wochen	
dólar	Nomen	v. 2 Wochen	
vehículos	Nomen	v. 2 Wochen	
yo	Pronomen	v. 2 Stunden	
en	Präposition	v. 2 Stunden	
cajeros	Nomen	v. 3 Wochen	
maestro	Nomen	v. 3 Wochen	
juega	Verb	v. 3 Wochen	
llevo	Verb	v. 3 Wochen	
sombreros	Nomen	v. 3 Wochen	
pago	Verb	v. 3 Wochen	
caballo	Nomen	v. 3 Stunden	
ella	Pronomen	v. 3 Stunden	
ellos	Pronomen	v. 3 Stunden	
más	Adverb	v. 3 Stunden	
no	Adverb	v. 3 Stunden	
lo	Pronomen	v. 3 Stunden	
mi	Bestimmungswort	v. 3 Stunden	
mis	Bestimmungswort	v. 3 Stunden	
eso	Pronomen	v. 3 Stunden	
los	Bestimmungswort	v. 3 Stunden	
sí	Adverb	v. 3 Stunden	
que	Konjunktion	v. 3 Stunden	
niño	Nomen	v. 3 Stunden	
de	Präposition	v. 3 Stunden	
así	Adverb	v. 3 Wochen	
histórica	Adjektiv	v. 3 Wochen	
posible	Adjektiv	v. 3 Wochen	
inteligentes	Adjektiv	v. 3 Wochen	
su	Bestimmungswort	v. 3 Stunden	
dónde	Adverb	v. 3 Stunden	
tú	Pronomen	v. 3 Stunden	
me	Pronomen	v. 3 Stunden	
abre	Verb	v. 3 Wochen	
este	Bestimmungswort	v. 3 Wochen	
pocas	Bestimmungswort	v. 3 Wochen	
algunas	Bestimmungswort	v. 3 Wochen	
algunos	Bestimmungswort	v. 3 Wochen	
muchas	Bestimmungswort	v. 3 Wochen	
niñas	Nomen	v. 3 Wochen	
fácilmente	Adverb	v. 3 Wochen	
sótano	Nomen	v. 3 Wochen	
pasado	Adjektiv	v. 3 Wochen	
popular	Adjektiv	v. 3 Wochen	
rato	Nomen	v. 3 Wochen	
artistas	Nomen	v. 3 Wochen	
profesora	Nomen	v. 3 Wochen	
duerme	Verb	v. 3 Wochen	
fruta	Nomen	v. 43 Minuten	
limón	Nomen	v. 43 Minuten	
elefantes	Nomen	v. 3 Wochen	
pato	Nomen	v. 3 Wochen	
rojo	Adjektiv	v. 3 Wochen	
doble	Nomen	v. 3 Wochen	
tercer	Bestimmungswort	v. 3 Wochen	
ésta	Pronomen	v. 3 Wochen	
ambos	Bestimmungswort	v. 3 Wochen	
aquel	Bestimmungswort	v. 3 Wochen	
aquella	Bestimmungswort	v. 3 Wochen	
malo	Adjektiv	v. 3 Wochen	
da	Verb	v. 3 Wochen	
estás	Verb	v. 3 Wochen	
estoy	Verb	v. 3 Wochen	
estamos	Verb	v. 3 Wochen	
horno	Nomen	v. 3 Wochen	
cebolla	Nomen	v. 43 Minuten	
vez	Nomen	v. 3 Wochen	
coronel	Nomen	v. 4 Wochen	
próxima	Adjektiv	v. 4 Wochen	
mayores	Adjektiv	v. 4 Wochen	
primero	Adjektiv	v. 4 Wochen	
cuánto	Bestimmungswort	v. 4 Wochen	
fuera	Verb	v. 4 Wochen	
hicieras	Verb	v. 4 Wochen	
hubiera	Verb	v. 4 Wochen	
tuvieras	Verb	v. 4 Wochen	
iríamos	Verb	v. 4 Wochen	
escribiría	Verb	v. 4 Wochen	
escribirían	Verb	v. 4 Wochen	
comerían	Verb	v. 4 Wochen	
diría	Verb	v. 4 Wochen	
sería	Verb	v. 4 Wochen	
requiere	Verb	v. 4 Wochen	
cuenta	Verb	v. 4 Wochen	
cierra	Verb	v. 4 Wochen	
siguen	Verb	v. 4 Wochen	
temporada	Nomen	v. 4 Wochen	
comandante	Nomen	v. 4 Wochen	
importan	Verb	v. 4 Wochen	
ayudamos	Verb	v. 4 Wochen	
presenta	Verb	v. 4 Wochen	
toma	Verb	v. 4 Wochen	
tomamos	Verb	v. 4 Wochen	
presentamos	Verb	v. 4 Wochen	
tomate	Nomen	v. 43 Minuten	
papa	Nomen	v. 43 Minuten	
firmamos	Verb	v. 4 Wochen	
aparecen	Verb	v. 4 Wochen	
aparece	Verb	v. 4 Wochen	
estudia	Verb	v. 4 Wochen	
parece	Verb	v. 4 Wochen	
lleva	Verb	v. 4 Wochen	
estudio	Verb	v. 4 Wochen	
firma	Verb	v. 4 Wochen	
parecen	Verb	v. 4 Wochen	
inglés	Nomen	v. 4 Wochen	
cierto	Adjektiv	v. 4 Wochen	
blancos	Adjektiv	v. 4 Wochen	
cuna	Nomen	v. 4 Wochen	
pared	Nomen	v. 4 Wochen	
abogados	Nomen	v. 4 Wochen	
pantalones	Nomen	v. 4 Wochen	
cinturón	Nomen	v. 4 Wochen	
contra	Präposition	v. 4 Wochen	
miraba	Verb	v. 1 Monat	
esperabas	Verb	v. 1 Monat	
hablaba	Verb	v. 1 Monat	
seguían	Verb	v. 1 Monat	
trataba	Verb	v. 1 Monat	
invierno	Nomen	v. 1 Monat	
cuchillo	Nomen	v. 1 Monat	
carpintera	Nomen	v. 1 Monat	
carpintero	Nomen	v. 1 Monat	
comer	Verb	v. 3 Stunden	
entrega	Verb	v. 1 Monat	
imposible	Adjektiv	v. 1 Monat	
normal	Adjektiv	v. 1 Monat	
segura	Adjektiv	v. 1 Monat	
rápido	Adjektiv	v. 1 Monat	
bueno	Adjektiv	v. 1 Monat	
esposo	Nomen	v. 1 Monat	
marido	Nomen	v. 1 Monat	
conmigo	Präposition	v. 3 Stunden	
daba	Verb	v. 1 Monat	
iban	Verb	v. 1 Monat	
sabía	Verb	v. 1 Monat	
teníamos	Verb	v. 1 Monat	
bebías	Verb	v. 1 Monat	
hacía	Verb	v. 1 Monat	
comías	Verb	v. 1 Monat	
bebía	Verb	v. 1 Monat	
comía	Verb	v. 1 Monat	
era	Verb	v. 1 Monat	
estaba	Verb	v. 1 Monat	
necesario	Adjektiv	v. 1 Monat	
menor	Adjektiv	v. 1 Monat	
caros	Adjektiv	v. 1 Monat	
personal	Adjektiv	v. 1 Monat	
libro	Nomen	v. 16 Stunden	
somos	Verb	v. 16 Stunden	
públicos	Adjektiv	v. 1 Monat	
cajeras	Nomen	v. 1 Monat	
siguiente	Adjektiv	v. 1 Monat	
bajos	Adjektiv	v. 1 Monat	
pollo	Nomen	v. 43 Minuten	
vestidos	Nomen	v. 1 Monat	
sobre	Präposition	v. 3 Stunden	
emparedado	Nomen	v. 43 Minuten	
agente	Nomen	v. 1 Monat	
sábado	Nomen	v. 1 Monat	
negra	Adjektiv	v. 1 Monat	
adiós	Interjektion	v. 1 Monat	
regular	Adjektiv	v. 3 Stunden	
dueño	Nomen	v. 1 Monat	
granjero	Nomen	v. 1 Monat	
atleta	Nomen	v. 1 Monat	
reina	Nomen	v. 1 Monat	
secretario	Nomen	v. 1 Monat	
atletas	Nomen	v. 1 Monat	
panadero	Nomen	v. 1 Monat	
especialistas	Nomen	v. 1 Monat	
y	Konjunktion	gestern	
cama	Nomen	v. 1 Monat	
teléfono	Nomen	v. 1 Monat	
lavadora	Nomen	v. 1 Monat	
refrigerador	Nomen	v. 1 Monat	
gracias	Interjektion	gestern	
esto	Pronomen	gestern	
a	Präposition	gestern	
tres	Zahl	gestern	
sus	Bestimmungswort	gestern	
eres	Verb	gestern	
empleados	Nomen	v. 1 Monat	
sofá	Nomen	v. 1 Monat	
cepillo	Nomen	v. 1 Monat	
tío	Nomen	v. 1 Monat	
septiembre	Nomen	v. 1 Monat	
viernes	Nomen	v. 1 Monat	
martes	Nomen	v. 1 Monat	
bebé	Nomen	v. 1 Monat	
papá	Nomen	v. 1 Monat	
sencillo	Adjektiv	v. 3 Stunden	
queso	Nomen	gestern	
abuelos	Nomen	v. 1 Monat	
roja	Adjektiv	v. 1 Monat	
pregunta	Nomen	v. 1 Monat	
caminan	Verb	v. 1 Monat	
camino	Verb	v. 1 Monat	
corremos	Verb	v. 1 Monat	
corres	Verb	v. 1 Monat	
dormimos	Verb	v. 1 Monat	
falda	Nomen	v. 1 Monat	
calcetines	Nomen	v. 1 Monat	
camisa	Nomen	v. 1 Monat	
pista	Nomen	v. 3 Stunden	
oficina	Nomen	v. 3 Stunden	
bebemos	Verb	v. 1 Monat	
lees	Verb	v. 1 Monat	
coméis	Verb	v. 1 Monat	
escribes	Verb	v. 1 Monat	
escribe	Verb	v. 1 Monat	
leéis	Verb	v. 1 Monat	
escriben	Verb	v. 1 Monat	
aquí	Adverb	v. 2 Tagen	
para	Präposition	v. 2 Tagen	
por	Präposition	v. 2 Tagen	
agua	Nomen	v. 2 Tagen	
mañana	Adverb	v. 2 Tagen	
algo	Pronomen	v. 3 Stunden	
beneficios	Nomen	v. 1 Monat	
progresos	Nomen	v. 1 Monat	
disciplinas	Nomen	v. 1 Monat	
sitio	Nomen	v. 1 Monat	
disciplina	Nomen	v. 1 Monat	
ideas	Nomen	v. 1 Monat	
forma	Nomen	v. 1 Monat	
causa	Nomen	v. 1 Monat	
formas	Nomen	v. 1 Monat	
causas	Nomen	v. 1 Monat	
fuerza	Nomen	v. 1 Monat	
reacciones	Nomen	v. 1 Monat	
responsabilidad	Nomen	v. 1 Monat	
reacción	Nomen	v. 1 Monat	
razón	Nomen	v. 1 Monat	
descripción	Nomen	v. 1 Monat	
fama	Nomen	v. 1 Monat	
daño	Nomen	v. 1 Monat	
perfil	Nomen	v. 1 Monat	
igualdad	Nomen	v. 1 Monat	
bienestar	Nomen	v. 1 Monat	
destrucción	Nomen	v. 1 Monat	
rivales	Nomen	v. 1 Monat	
símbolo	Nomen	v. 1 Monat	
revisión	Nomen	v. 1 Monat	
conclusión	Nomen	v. 1 Monat	
opciones	Nomen	v. 1 Monat	
conclusiones	Nomen	v. 1 Monat	
permiso	Nomen	v. 1 Monat	
conservación	Nomen	v. 1 Monat	
nos	Pronomen	v. 1 Monat	
aventura	Nomen	v. 1 Monat	
transporte	Nomen	v. 1 Monat	
introducción	Nomen	v. 1 Monat	
variedad	Nomen	v. 1 Monat	
cola	Nomen	v. 1 Monat	
cantidad	Nomen	v. 1 Monat	
oportunidades	Nomen	v. 1 Monat	
ventaja	Nomen	v. 1 Monat	
ventajas	Nomen	v. 1 Monat	
publicación	Nomen	v. 1 Monat	
círculo	Nomen	v. 1 Monat	
actitud	Nomen	v. 1 Monat	
instalación	Nomen	v. 1 Monat	
fenómeno	Nomen	v. 1 Monat	
infancia	Nomen	v. 1 Monat	
colección	Nomen	v. 1 Monat	
transformación	Nomen	v. 1 Monat	
evidencia	Nomen	v. 1 Monat	
obligación	Nomen	v. 1 Monat	
humo	Nomen	v. 2 Stunden	
imaginación	Nomen	v. 1 Monat	
dificultades	Nomen	v. 1 Monat	
queremos	Verb	v. 1 Monat	
quisiera	Verb	v. 1 Monat	
quisieras	Verb	v. 1 Monat	
quieren	Verb	v. 1 Monat	
nadie	Pronomen	v. 3 Stunden	
pude	Verb	v. 1 Monat	
debería	Verb	v. 1 Monat	
podría	Verb	v. 1 Monat	
debía	Verb	v. 1 Monat	
ven	Verb	v. 1 Monat	
llama	Verb	v. 1 Monat	
mira	Verb	v. 1 Monat	
digan	Verb	v. 1 Monat	
decid	Verb	v. 1 Monat	
firmemos	Verb	v. 1 Monat	
digamos	Verb	v. 1 Monat	
pague	Verb	v. 1 Monat	
ten	Verb	v. 1 Monat	
tengan	Verb	v. 1 Monat	
nuestras	Bestimmungswort	v. 2 Tagen	
disponible	Adjektiv	v. 3 Stunden	
al	Präposition	v. 3 Stunden	
ellas	Pronomen	v. 3 Tagen	
elefante	Nomen	v. 3 Tagen	
oso	Nomen	v. 3 Tagen	
gato	Nomen	v. 3 Tagen	
qué	Pronomen	v. 3 Tagen	
núcleo	Nomen	v. 1 Monat	
proporción	Nomen	v. 1 Monat	
observación	Nomen	v. 1 Monat	
atmósfera	Nomen	v. 1 Monat	
tesis	Nomen	v. 1 Monat	
límite	Nomen	v. 1 Monat	
equilibrio	Nomen	v. 1 Monat	
fórmula	Nomen	v. 1 Monat	
velocidad	Nomen	v. 1 Monat	
elemento	Nomen	v. 1 Monat	
elementos	Nomen	v. 1 Monat	
instituto	Nomen	v. 3 Stunden	
física	Nomen	v. 1 Monat	
superficie	Nomen	v. 1 Monat	
tecnología	Nomen	v. 1 Monat	
puntos	Nomen	v. 1 Monat	
energía	Nomen	v. 1 Monat	
funciones	Nomen	v. 1 Monat	
punto	Nomen	v. 1 Monat	
medidas	Nomen	v. 1 Monat	
línea	Nomen	v. 1 Monat	
ayer	Adverb	v. 3 Tagen	
diferencia	Nomen	v. 1 Monat	
legislación	Nomen	v. 1 Monat	
pobreza	Nomen	v. 1 Monat	
imperio	Nomen	v. 1 Monat	
estabilidad	Nomen	v. 1 Monat	
dictadura	Nomen	v. 1 Monat	
riqueza	Nomen	v. 1 Monat	
agricultura	Nomen	v. 1 Monat	
impuesto	Nomen	v. 1 Monat	
embajador	Nomen	v. 1 Monat	
manifestaciones	Nomen	v. 1 Monat	
impuestos	Nomen	v. 1 Monat	
federación	Nomen	v. 1 Monat	
independencia	Nomen	v. 1 Monat	
cooperación	Nomen	v. 1 Monat	
presupuesto	Nomen	v. 1 Monat	
candidatos	Nomen	v. 1 Monat	
estrategia	Nomen	v. 1 Monat	
federal	Adjektiv	v. 1 Monat	
conflictos	Nomen	v. 1 Monat	
libros	Nomen	v. 4 Tagen	
hombre	Nomen	v. 4 Tagen	
pescado	Nomen	v. 4 Tagen	
organismos	Nomen	v. 1 Monat	
discurso	Nomen	v. 1 Monat	
líder	Nomen	v. 1 Monat	
alcalde	Nomen	v. 1 Monat	
declaración	Nomen	v. 1 Monat	
organismo	Nomen	v. 1 Monat	
constitución	Nomen	v. 1 Monat	
campaña	Nomen	v. 1 Monat	
ejército	Nomen	v. 1 Monat	
república	Nomen	v. 1 Monat	
socialista	Adjektiv	v. 1 Monat	
justicia	Nomen	v. 1 Monat	
administración	Nomen	v. 1 Monat	
plan	Nomen	v. 1 Monat	
ministerio	Nomen	v. 1 Monat	
libertad	Nomen	v. 1 Monat	
político	Nomen	v. 1 Monat	
ministra	Nomen	v. 1 Monat	
políticos	Nomen	v. 1 Monat	
ministro	Nomen	v. 1 Monat	
derecho	Nomen	v. 1 Monat	
jugo	Nomen	v. 3 Tagen	
guerra	Nomen	v. 1 Monat	
gobiernos	Nomen	v. 1 Monat	
animales	Nomen	gestern	
huevo	Nomen	v. 3 Tagen	
e	Konjunktion	gestern	
leche	Nomen	v. 4 Tagen	
cartas	Nomen	v. 4 Tagen	
animal	Nomen	v. 4 Tagen	
novela	Nomen	v. 1 Monat	
letras	Nomen	v. 1 Monat	
espectáculo	Nomen	v. 1 Monat	
discos	Nomen	v. 1 Monat	
instrumentos	Nomen	v. 1 Monat	
instrumento	Nomen	v. 1 Monat	
sonido	Nomen	v. 1 Monat	
moda	Nomen	v. 1 Monat	
tocar	Verb	v. 1 Monat	
corriente	Nomen	v. 2 Stunden	
raíz	Nomen	v. 2 Stunden	
estilo	Nomen	v. 1 Monat	
poesía	Nomen	v. 1 Monat	
teatro	Nomen	v. 1 Monat	
literatura	Nomen	v. 1 Monat	
oscuro	Adjektiv	v. 3 Stunden	
mujer	Nomen	v. 6 Tagen	
nosotros	Pronomen	v. 6 Tagen	
cuál	Pronomen	v. 6 Tagen	
vino	Nomen	gestern	
hoy	Adverb	v. 3 Tagen	
usted	Pronomen	v. 2 Tagen	
tu	Bestimmungswort	gestern	
nuestro	Bestimmungswort	v. 1 Woche	
diario	Nomen	v. 1 Woche	
cuáles	Pronomen	v. 1 Woche	
paso	Nomen	gestern	
llegará	Verb	v. 1 Monat	
sin	Präposition	v. 2 Tagen	
seremos	Verb	v. 1 Monat	
beberán	Verb	v. 1 Monat	
tendrás	Verb	v. 1 Monat	
estarás	Verb	v. 1 Monat	
comeremos	Verb	v. 1 Monat	
verán	Verb	v. 1 Monat	
tendré	Verb	v. 1 Monat	
será	Verb	v. 1 Monat	
santo	Adjektiv	v. 1 Monat	
iglesias	Nomen	v. 1 Monat	
iglesia	Nomen	v. 1 Monat	
cruz	Nomen	v. 1 Monat	
religiosa	Adjektiv	v. 1 Monat	
tradición	Nomen	v. 1 Monat	
dioses	Nomen	v. 1 Monat	
espíritus	Nomen	v. 1 Monat	
ángel	Nomen	v. 1 Monat	
alma	Nomen	v. 1 Monat	
nada	Pronomen	v. 3 Stunden	
que		v. 3 Stunden	
publicidad	Nomen	v. 1 Monat	
internet	Nomen	v. 1 Monat	
estampillas	Nomen	v. 1 Monat	
postal	Nomen	v. 1 Monat	
editorial	Nomen	v. 1 Monat	
entrevista	Nomen	v. 1 Monat	
comentarios	Nomen	v. 1 Monat	
mensajes	Nomen	v. 1 Monat	
grito	Nomen	v. 1 Monat	
noticias	Nomen	v. 1 Monat	
llamada	Nomen	v. 1 Monat	
artículo	Nomen	v. 1 Monat	
lenguajes	Nomen	v. 1 Monat	
lenguaje	Nomen	v. 1 Monat	
prensa	Nomen	v. 1 Monat	
comunicaciones	Nomen	v. 1 Monat	
células	Nomen	v. 2 Stunden	
montaña	Nomen	v. 2 Stunden	
perro	Nomen	v. 1 Woche	
inversión	Nomen	v. 1 Monat	
económica	Adjektiv	v. 1 Monat	
negociación	Nomen	v. 1 Monat	
inflación	Nomen	v. 1 Monat	
conferencia	Nomen	v. 1 Monat	
económico	Adjektiv	v. 1 Monat	
mercados	Nomen	v. 1 Monat	
propiedad	Nomen	v. 1 Monat	
reunión	Nomen	v. 1 Monat	
reuniones	Nomen	v. 1 Monat	
oro	Nomen	v. 1 Monat	
sopa	Nomen	v. 1 Woche	
mujeres	Nomen	gestern	
arroz	Nomen	gestern	
costo	Nomen	v. 1 Monat	
productos	Nomen	v. 1 Monat	
producto	Nomen	v. 1 Monat	
fortuna	Nomen	v. 1 Monat	
industria	Nomen	v. 1 Monat	
valor	Nomen	v. 1 Monat	
ejecutivo	Nomen	v. 1 Monat	
precio	Nomen	v. 1 Monat	
deuda	Nomen	v. 1 Monat	
tasa	Nomen	v. 1 Monat	
oferta	Nomen	v. 1 Monat	
ayuda	Nomen	v. 1 Monat	
grave	Adjektiv	v. 1 Monat	
virus	Nomen	v. 1 Monat	
órgano	Nomen	v. 1 Monat	
clínica	Nomen	v. 1 Monat	
dieta	Nomen	v. 1 Monat	
emociones	Nomen	v. 1 Monat	
emoción	Nomen	v. 1 Monat	
lágrimas	Nomen	v. 1 Monat	
muerta	Adjektiv	v. 1 Monat	
muertos	Adjektiv	v. 1 Monat	
cadáver	Nomen	v. 1 Monat	
órganos	Nomen	v. 1 Monat	
del	Präposition	v. 3 Tagen	
síntomas	Nomen	v. 1 Monat	
pacientes	Nomen	v. 1 Monat	
síntoma	Nomen	v. 1 Monat	
dosis	Nomen	v. 1 Monat	
paciente	Nomen	v. 1 Monat	
medicina	Nomen	v. 1 Monat	
presión	Nomen	v. 1 Monat	
condiciones	Nomen	v. 1 Monat	
enfermedad	Nomen	v. 1 Monat	
riesgos	Nomen	v. 1 Monat	
riesgo	Nomen	v. 1 Monat	
corazón	Nomen	v. 1 Monat	
ambulancia	Nomen	v. 1 Monat	
puerto	Nomen	v. 3 Stunden	
ruta	Nomen	v. 3 Stunden	
comida	Nomen	v. 1 Woche	
duele	Verb	v. 1 Monat	
rodilla	Nomen	v. 1 Monat	
pelo	Nomen	v. 1 Monat	
estómago	Nomen	v. 1 Monat	
manos	Nomen	v. 1 Monat	
lengua	Nomen	v. 1 Monat	
nuestra	Bestimmungswort	gestern	
carne	Nomen	v. 1 Woche	
menú	Nomen	v. 1 Woche	
manzana	Nomen	v. 1 Woche	
dedo	Nomen	v. 1 Monat	
ojo	Nomen	v. 1 Monat	
cabeza	Nomen	v. 1 Monat	
espalda	Nomen	v. 1 Monat	
labios	Nomen	v. 1 Monat	
brazo	Nomen	v. 1 Monat	
boca	Nomen	v. 1 Monat	
cuerpo	Nomen	v. 1 Monat	
brazos	Nomen	v. 1 Monat	
diarios	Nomen	v. 1 Woche	
mí	Pronomen	gestern	
simplemente	Adverb	v. 2 Tagen	
decirle	Pronomen	v. 1 Monat	
fresas	Nomen	v. 3 Tagen	
cómo	Adverb	v. 1 Woche	
niña	Nomen	v. 2 Wochen	
como	Konjunktion	v. 2 Tagen	
caminar	Verb	v. 1 Monat	
cinco	Zahl	v. 3 Tagen	
qué	Bestimmungswort	v. 4 Tagen	
niños	Nomen	v. 2 Wochen	
ratón	Nomen	v. 2 Wochen	
hombres	Nomen	gestern	
fresa	Nomen	v. 2 Wochen	
si	Konjunktion	v. 3 Tagen	
mono	Nomen	v. 3 Tagen	
mía	Adjektiv	v. 3 Tagen	
deportes	Nomen	v. 1 Monat	
cuatro	Zahl	v. 1 Monat	
carta	Nomen	v. 4 Tagen	
especiales	Adjektiv	v. 3 Stunden	
volcán	Nomen	v. 2 Stunden	
montañas	Nomen	v. 2 Stunden	
gol	Nomen	v. 1 Monat	
jugadores	Nomen	v. 1 Monat	
jugador	Nomen	v. 1 Monat	
legales	Adjektiv	gestern	
abierta	Adjektiv	gestern	
esta	Pronomen	v. 3 Stunden	
estas	Pronomen	v. 3 Stunden	
víctima	Nomen	v. 2 Tagen	
fracaso	Nomen	v. 1 Monat	
definición	Nomen	v. 1 Monat	
sueño	Nomen	v. 1 Monat	
ruido	Nomen	v. 1 Monat	
excepción	Nomen	v. 1 Monat	
impacto	Nomen	v. 1 Monat	
intensidad	Nomen	v. 1 Monat	
experiencias	Nomen	v. 1 Monat	
ya	Adverb	v. 3 Wochen	
león	Nomen	v. 4 Tagen	
té	Nomen	v. 6 Tagen	
sólo	Adverb	v. 2 Tagen	
plaza	Nomen	v. 3 Stunden	
sal	Nomen	v. 4 Tagen	
sirve	Verb	v. 1 Woche	
cerca	Präposition	v. 4 Tagen	
se	Pronomen	v. 4 Wochen	
llegada	Nomen	gestern	
pan	Nomen	v. 4 Wochen	
propuesta	Nomen	v. 1 Monat	
significado	Nomen	v. 1 Monat	
sesión	Nomen	v. 1 Monat	
concentración	Nomen	v. 1 Monat	
motivos	Nomen	v. 1 Monat	
honor	Nomen	v. 1 Monat	
esfuerzos	Nomen	v. 1 Monat	
caída	Nomen	v. 1 Monat	
factor	Nomen	v. 1 Monat	
esfuerzo	Nomen	v. 1 Monat	
misión	Nomen	v. 1 Monat	
perspectiva	Nomen	v. 1 Monat	
inmediatamente	Adverb	v. 2 Tagen	
hola	Interjektion	v. 1 Woche	
perdón	Nomen	gestern	
desde	Präposition	v. 1 Woche	
sombra	Nomen	v. 1 Monat	
división	Nomen	v. 1 Monat	
margen	Nomen	v. 1 Monat	
pájaro	Nomen	v. 4 Tagen	
bajo	Präposition	v. 1 Woche	
siempre	Adverb	v. 2 Tagen	
edición	Nomen	v. 1 Monat	
situación	Nomen	v. 1 Monat	
consecuencia	Nomen	v. 1 Monat	
versión	Nomen	v. 1 Monat	
intención	Nomen	v. 1 Monat	
relaciones	Nomen	v. 1 Monat	
ceremonia	Nomen	v. 1 Monat	
gesto	Nomen	v. 1 Monat	
tus	Bestimmungswort	v. 1 Woche	
ustedes	Pronomen	v. 2 Wochen	
gata	Nomen	v. 1 Monat	
muy	Adverb	v. 1 Monat	
nunca	Adverb	v. 1 Monat	
hay	Verb	v. 1 Monat	
según	Präposition	v. 4 Tagen	
raíces	Nomen	v. 2 Stunden	
quién	Pronomen	v. 2 Wochen	
perfectamente	Adverb	v. 2 Wochen	
cualquiera	Pronomen	v. 3 Stunden	
naturalmente	Adverb	v. 3 Tagen	
hospital	Nomen	v. 2 Tagen	
lugar	Nomen	v. 2 Tagen	
china	Eigenname	gestern	
señal	Nomen	gestern	
cerveza	Nomen	v. 1 Woche	
cerdo	Nomen	v. 4 Tagen	
lógica	Adjektiv	gestern	
argentina	Eigenname	gestern	
méxico	Eigenname	gestern	
españa	Eigenname	gestern	
hablar	Verb	v. 1 Monat	
posiblemente	Adverb	v. 3 Tagen	
lejos	Adverb	v. 3 Tagen	
definitivamente	Adverb	v. 3 Tagen	
rosa	Nomen	v. 2 Monaten	
rosas	Nomen	v. 2 Monaten	
arena	Nomen	v. 2 Monaten	
estrella	Nomen	v. 2 Monaten	
ambiente	Nomen	v. 2 Monaten	
nosotras	Pronomen	v. 2 Wochen	
mientras	Konjunktion	v. 3 Tagen	
bosque	Nomen	v. 2 Monaten	
hueso	Nomen	v. 2 Monaten	
dientes	Nomen	v. 2 Monaten	
tanto	Adverb	v. 2 Tagen	
planeta	Nomen	v. 2 Monaten	
clima	Nomen	v. 2 Monaten	
piedra	Nomen	v. 2 Monaten	
gas	Nomen	v. 2 Monaten	
piedras	Nomen	v. 2 Monaten	
calor	Nomen	v. 2 Monaten	
especie	Nomen	v. 2 Monaten	
madera	Nomen	v. 2 Monaten	
fuego	Nomen	v. 2 Monaten	
manzanas	Nomen	v. 6 Tagen	
escribir	Verb	v. 2 Monaten	
tortuga	Nomen	v. 4 Tagen	
absolutamente	Adverb	v. 2 Tagen	
setenta	Zahl	v. 3 Tagen	
árbol	Nomen	v. 2 Monaten	
mar	Nomen	v. 2 Monaten	
flor	Nomen	v. 2 Monaten	
pasto	Nomen	v. 2 Monaten	
recientemente	Adverb	v. 3 Tagen	
tampoco	Adverb	v. 3 Tagen	
entonces	Adverb	v. 3 Tagen	
pero	Konjunktion	v. 1 Woche	
gran	Adjektiv	v. 3 Tagen	
apenas	Adverb	v. 2 Tagen	
entre	Präposition	v. 1 Woche	
izquierda	Nomen	gestern	
tráfico	Nomen	gestern	
entrada	Nomen	gestern	
desayuno	Nomen	v. 2 Wochen	
inglaterra	Eigenname	gestern	
donde		v. 2 Wochen	
luego	Adverb	v. 2 Wochen	
conejo	Nomen	v. 1 Woche	
casi	Adverb	v. 2 Tagen	
menos	Adverb	v. 2 Tagen	
generalmente	Adverb	v. 3 Tagen	
completamente	Adverb	v. 3 Tagen	
gatas	Nomen	v. 1 Monat	
naranja	Nomen	v. 4 Tagen	
además	Adverb	v. 3 Wochen	
prácticamente	Adverb	v. 3 Wochen	
disculpe	Verb	v. 3 Wochen	
despacio	Adverb	v. 2 Wochen	
tan	Adverb	gestern	
todavía	Adverb	v. 2 Tagen	
almuerzo	Nomen	v. 4 Tagen	
actualmente	Adverb	v. 3 Tagen	
gafas	Nomen	v. 2 Wochen	
hacia	Präposition	v. 4 Tagen	
vacaciones	Nomen	v. 2 Wochen	
paraguas	Nomen	v. 2 Wochen	
oigo	Verb	gestern	
febrero	Nomen	v. 17 Stunden	
solamente	Adverb	v. 3 Tagen	
cubrir	Verb	v. 1 Monat	
araña	Nomen	v. 1 Monat	
cena	Nomen	v. 1 Woche	
porque	Konjunktion	v. 1 Woche	
come	Verb	v. 4 Monaten	
bebe	Verb	v. 4 Monaten	
numerosos	Adjektiv	gestern	
patos	Nomen	v. 4 Tagen	
igualmente	Adverb	v. 2 Wochen	
emparedados	Nomen	v. 2 Wochen	
último	Bestimmungswort	v. 16 Stunden	
principalmente	Adverb	v. 3 Tagen	
tamaño	Nomen	v. 3 Tagen	
pingüino	Nomen	v. 4 Tagen	
visita	Verb	v. 1 Woche	
amiga	Nomen	v. 2 Tagen	
pareja	Nomen	v. 2 Tagen	
adelante	Adverb	v. 3 Tagen	
cuando	Konjunktion	v. 1 Woche	
exactamente	Adverb	v. 3 Tagen	
beben	Verb	v. 4 Monaten	
profesional	Adjektiv	v. 16 Stunden	
ni	Konjunktion	v. 2 Wochen	
competencia	Nomen	v. 2 Monaten	
mío	Adjektiv	v. 1 Woche	
un	Bestimmungswort	v. 3 Monaten	
caballos	Nomen	v. 1 Woche	
ir	Verb	v. 4 Wochen	
cangrejo	Nomen	v. 4 Tagen	
pronto	Adverb	v. 1 Monat	
una	Bestimmungswort	v. 3 Monaten	
caer	Verb	v. 2 Monaten	
limpio	Verb	v. 2 Tagen	
realmente	Adverb	v. 2 Wochen	
dedos	Nomen	v. 1 Monat	
dos	Zahl	v. 1 Monat	
sentimiento	Nomen	v. 2 Monaten	
celebración	Nomen	v. 2 Monaten	
nervioso	Adjektiv	v. 2 Monaten	
deseo	Nomen	v. 2 Monaten	
nerviosa	Adjektiv	v. 2 Monaten	
curiosidad	Nomen	v. 2 Monaten	
placer	Nomen	v. 2 Monaten	
sorpresa	Nomen	v. 2 Monaten	
temor	Nomen	v. 2 Monaten	
esperanza	Nomen	v. 2 Monaten	
soledad	Nomen	v. 2 Monaten	
personalidad	Nomen	v. 2 Monaten	
miedo	Nomen	v. 2 Monaten	
dolor	Nomen	v. 2 Monaten	
sonrisa	Nomen	v. 2 Monaten	
amistad	Nomen	v. 2 Monaten	
amor	Nomen	v. 2 Monaten	
feliz	Adjektiv	v. 2 Monaten	
felicidad	Nomen	v. 2 Monaten	
tensión	Nomen	v. 2 Monaten	
cocinada	Verb	v. 2 Monaten	
hecha	Verb	v. 2 Monaten	
conocida	Verb	v. 2 Monaten	
orden	Nomen	v. 1 Monat	
también	Adverb	v. 3 Tagen	
ocho	Zahl	v. 3 Tagen	
acceso	Nomen	v. 2 Monaten	
términos	Nomen	v. 2 Monaten	
selecciones	Nomen	v. 2 Monaten	
siete	Zahl	v. 3 Tagen	
seguramente	Adverb	v. 3 Tagen	
debajo	Adverb	v. 3 Tagen	
parís	Eigenname	v. 2 Monaten	
quizá	Adverb	v. 3 Tagen	
quizás	Adverb	v. 2 Wochen	
bastante	Adverb	v. 2 Wochen	
cumpleaños	Nomen	v. 2 Wochen	
ocasión	Nomen	v. 2 Monaten	
aspecto	Nomen	v. 2 Monaten	
principios	Nomen	v. 2 Monaten	
memoria	Nomen	v. 2 Monaten	
tratar	Verb	v. 1 Monat	
mundo	Nomen	v. 2 Monaten	
mucho	Adverb	v. 2 Wochen	
antes	Adverb	v. 3 Wochen	
miro	Verb	v. 1 Woche	